TILEMAP
20 15 							-- Size of tile map in tiles
16 16 							-- Tile size & block size
images/tileset_lv2.png 	        -- Tilesheet
11 11 							-- Number of tiles in tilesheet
0 0 0 0 0 0 0 0 0 0 0 0 0 0 0 0 0 0 0 0
0 0 0 0 0 0 0 0 0 0 0 0 0 0 0 0 0 0 0 0
0 0 1 2 3 4 5 6 7 8 9 11 11 13 14 15 16 17 0 0
0 0 18 19 20 22 23 23 23 24 25 26 26 26 27 28 60 30 0 0
0 0 31 33 34 35 36 37 38 39 40 38 41 42 44 45 46 47 0 0
0 0 18 48 60 50 51 52 18 53 55 18 56 57 58 48 60 18 0 0
0 0 18 48 60 18 61 62 18 63 64 18 66 67 18 48 60 18 0 0
0 0 18 48 60 18 61 68 69 70 71 69 72 67 18 48 60 18 0 0
0 0 18 48 60 18 73 74 75 75 75 75 77 78 18 48 60 18 0 0
0 0 18 48 79 80 81 82 82 82 82 82 82 83 84 85 60 18 0 0
0 0 18 86 88 89 90 90 90 90 90 90 90 90 91 92 93 18 0 0
0 0 94 95 96 99 99 99 99 99 99 99 99 99 99 100 101 102 0 0
0 0 18 103 105 105 105 105 105 105 105 105 105 105 105 105 106 18 0 0
108 108 108 108 108 108 108 108 108 108 108 108 108 108 108 108 108 108 108 108
108 108 108 108 108 108 108 108 108 108 108 108 108 108 108 108 108 108 108 108
0 0 0 0 0 0 0 0 0 0 0 0 0 0 0 0 0 0 0 0
0 0 0 0 0 0 0 0 0 0 0 0 0 0 0 0 0 0 0 0
0 0 0 0 0 0 0 0 0 0 0 0 0 0 0 0 0 0 0 0
0 0 0 0 -1 -1 -1 -1 -1 -1 -1 -1 -1 -1 -1 -1 0 0 0 0
0 0 0 0 -1 -1 -1 -1 -1 -1 -1 -1 -1 -1 -1 -1 0 0 0 0
0 0 0 0 -1 -1 -1 -1 -1 -1 -1 -1 -1 -1 -1 -1 0 0 0 0
0 0 0 0 -1 -1 -1 -1 -1 -1 -1 -1 -1 -1 -1 -1 0 0 0 0
0 0 0 0 -1 -1 -1 -1 -1 -1 -1 -1 -1 -1 -1 -1 0 0 0 0
0 0 0 0 -1 -1 -1 -1 -1 -1 -1 -1 -1 -1 -1 -1 0 0 0 0
0 0 0 0 -1 -1 -1 -1 -1 -1 -1 -1 -1 -1 -1 -1 0 0 0 0
0 0 0 0 -1 -1 -1 -1 -1 -1 -1 -1 -1 -1 -1 -1 0 0 0 0
0 0 0 0 -1 -1 -1 -1 -1 -1 -1 -1 -1 -1 -1 -1 0 0 0 0
0 0 0 0 0 0 0 0 0 0 0 0 0 0 0 0 0 0 0 0
0 0 0 0 0 0 0 0 0 0 0 0 0 0 0 0 0 0 0 0
0 0 0 0 0 0 0 0 0 0 0 0 0 0 0 0 0 0 0 0
10 9                // initial pos player 
