TILEMAP
20 15 							-- Size of tile map in tiles
16 16 							-- Tile size & block size
images/tileset_lv1.png 	        -- Tilesheet
8 8 							-- Number of tiles in tilesheet
7 7 7 7 7 7 7 7 7 7 7 7 7 7 7 7 7 7 7 7
7 7 7 7 7 7 7 7 7 7 7 7 7 7 7 7 7 7 7 7
7 7 -1 -1 -1 -1 -1 -1 -1 -1 -1 -1 -1 -1 -1 -1 -1 -1 7 7
7 7 -1 -1 -1 -1 -1 -1 -1 -1 -1 -1 -1 -1 -1 -1 -1 -1 7 7
7 7 -1 -1 -1 -1 -1 -1 -1 -1 -1 -1 -1 -1 -1 -1 -1 -1 7 7
7 7 -1 -1 -1 -1 -1 -1 -1 -1 -1 -1 -1 -1 -1 -1 -1 -1 7 7
7 7 -1 -1 -1 -1 -1 -1 -1 -1 -1 -1 -1 -1 -1 -1 -1 -1 7 7
7 7 -1 -1 -1 -1 -1 -1 -1 -1 -1 -1 -1 -1 -1 -1 -1 -1 7 7
7 7 -1 -1 -1 -1 -1 -1 -1 -1 -1 -1 -1 -1 -1 -1 -1 -1 7 7
7 7 -1 -1 -1 -1 -1 -1 -1 -1 -1 -1 -1 -1 -1 -1 -1 -1 7 7
7 7 -1 -1 -1 -1 -1 -1 -1 -1 -1 -1 -1 -1 -1 -1 -1 -1 7 7
7 7 -1 -1 -1 -1 -1 -1 -1 -1 -1 -1 -1 -1 -1 -1 -1 -1 7 7
7 7 -1 -1 -1 -1 -1 -1 -1 -1 -1 -1 -1 -1 -1 -1 -1 -1 7 7
38 38 38 38 38 38 38 38 38 38 38 38 38 38 38 38 38 38 38 38
38 38 38 38 38 38 38 38 38 38 38 38 38 38 38 38 38 38 38 38
7 7 7 7 7 7 7 7 7 7 7 7 7 7 7 7 7 7 7 7
7 7 7 7 7 7 7 7 7 7 7 7 7 7 7 7 7 7 7 7
7 7 7 7 7 7 7 -1 -1 -1 -1 -1 -1 7 7 7 7 7 7 7
7 7 7 7 7 7 7 -1 -1 -1 -1 -1 -1 7 7 7 7 7 7 7
7 7 7 7 7 7 7 -1 -1 -1 -1 -1 -1 7 7 7 7 7 7 7
7 7 7 7 7 7 7 -1 -1 -1 -1 -1 -1 7 7 7 7 7 7 7
7 7 7 7 7 7 7 -1 -1 -1 -1 -1 -1 7 7 7 7 7 7 7
7 7 7 7 7 7 7 -1 -1 -1 -1 -1 -1 7 7 7 7 7 7 7
7 7 7 7 7 7 7 7 7 7 7 7 7 7 7 7 7 7 7 7
7 7 7 7 -1 -1 -1 -1 -1 -1 -1 -1 -1 -1 -1 -1 7 7 7 7
7 7 7 7 -1 -1 -1 -1 -1 -1 -1 -1 -1 -1 -1 -1 7 7 7 7
7 7 7 7 -1 -1 -1 -1 -1 -1 -1 -1 -1 -1 -1 -1 7 7 7 7
7 7 7 7 7 7 7 7 7 7 7 7 7 7 7 7 7 7 7 7
7 7 7 7 7 7 7 7 7 7 7 7 7 7 7 7 7 7 7 7
7 7 7 7 7 7 7 7 7 7 7 7 7 7 7 7 7 7 7 7
10 9                // initial pos player 

